NO ./textures/north.xpm
SO ./textures/south.xpm
WE ./textures/west.xpm
EA ./textures/east.xpm

F 100,80,50
C 30,60,120

111111111111111111111111111111111111111
100000000001000000000000000000000000001
101111111101011111011111111011111111101
101000000101010001010000001010000000101
101011111101010101010111111010111111101
101010000001010101000100000010100000101
101010111111110101111101111110101111101
101010100000000101000001000000101000101
101010101111111101011111101111101011101
101010001000000001010000001000001010001
101011111011111111010111111011111010101
101000000010000000010000000010000010101
101111111110111111111011111110111110101
100000000000000000000000000000000000101
111011111111111011111111111111111110101
101010000000001010000000000000000010101
101010111111101011111111111111111010101
101010100000101000000000000000001010101
101010101111101111111111111111101010101
101010001000000000000000000000001010101
101011111011111111111111111111111010101
100000000010000000000000000000000010101
111111111110111111111111111111111110101
100000000000000000000000000000000000101
101111111111111111111111111111111110101
101000000000000000000000000000000010101
101011111111111111111111111111111010101
101010000000000000000000000000001010001
101010111111111111111111111111101011101
101010100000000000000000000000101010101
101010101111111111111111111110101010101
101010001000000000000000000010001010101
101011111011111111111111111110111010101
100000000010000000N00000000000000010101
111111111110111111111111111111111110101
100000000000000000000000000000000000001
111111111111111111111111111111111111111
