 NO ./textures/north.xpm
SO ./textures/south.xpm
WE ./textures/west.xpm
EA ./textures/east.xpm

F 100,100,100
C 50,50,200

111111111111111111111
100000000000000000001
100000000000000000001
1000011111110000000001
1000010000010000000001
1000010000010000N0001
1000010000010000000001
1000011111110000000001
100000000000000000001
100000000000000000001
111111111111111111111
